6,7,
1,1,1,1,1,1,
1,3,2,2,6,1,
1,5,2,2,4,1,
1,7,0,0,10,1,
1,12,12,12,14,1,
1,15,8,9,16,1,
1,1,-1,-1,1,1,
